1 2 1 1 3 4 1 1 1 5 6 7 6 3 1 1 
1 1 1 8 1 4 1 1 1 4 1 1 1 1 9 1 
1 1 1 1 1 10 11 12 12 12 12 12
1 1 1 13 14 15 1 1 1 1 1 1 1 1 1 16 
1 17 1 1 1 1 2 18 1 1 10 16 1 19 1 1 
1 20 21 22 1 1 23 12 12 12 12 12
1 1 1 1 1 1 1 1 1 1 1 1 1 1 1 1 
1 1 13 16 24 25 1 26 27 27 28 1 1 1 19 1 
1 1 1 29 1 21 23 12 12 12 12 12
1 1 1 1 1 1 1 1 1 1 1 1 1 1 1 1 
1 1 1 1 1 1 30 1 1 1 1 1 1 1 1 1 
1 1 1 29 1 1 23 12 12 12 12 12
1 31 32 1 1 33 1 1 34 35 36 37 38 1 1 1 
1 1 39 1 1 1 1 1 1 31 40 1 1 1 1 1 
1 1 41 42 43 44 45 12 12 12 12 12
46 47 1 48 49 50 51 52 53 54 1 55 56 57 58 59 
1 1 1 1 60 61 62 63 1 64 64 1 1 65 66 1 
1 67 68 69 1 70 71 12 72 73 74 75
76 77 78 79 80 81 82 83 84 85 86 87 88 89 90 91 
92 93 94 95 96 97 98 99 100 101 102 103 104 105 106 107 
107 108 109 110 111 112 113 114 115 116 114 117
12 12 12 12 12 12 12 12 12 12 12 12 12 12 12 12 
12 12 12 12 12 12 12 12 12 12 12 12 12 12 118 119 
120 121 122 122 123 119 124 12 12 12 12 12
12 12 12 12 12 12 12 12 12 12 12 12 12 12 12 12 
12 12 12 12 12 12 12 12 12 12 12 12 12 12 125 126 
127 12 12 128 129 126 127 12 12 12 12 12
12 12 12 12 12 12 12 12 12 12 12 12 12 12 12 12 
12 12 12 12 12 12 12 12 12 12 12 12 12 12 125 126 
130 131 132 133 126 126 127 12 12 12 12 12