1 2 1 1 3 4 1 1 1 5 6 7 6 3 1 1 
1 1 1 8 1 4 1 1 1 4 1 1 1 1 9 1 
1 1 1 1 1 10 11 12 12 12 12 12
1 1 1 13 14 15 1 1 1 1 1 1 1 1 1 16 
1 17 1 1 1 1 2 18 1 1 10 16 1 19 1 1 
1 20 21 1 1 1 22 12 12 12 12 12
1 1 1 1 1 1 1 1 1 1 1 1 1 1 1 1 
1 1 13 16 23 24 1 25 26 26 27 1 1 1 19 1 
1 1 1 1 1 21 22 12 12 12 12 12
1 1 1 1 1 1 1 1 1 1 1 1 1 1 1 1 
1 1 1 1 1 1 28 1 1 1 1 1 1 1 1 1 
1 1 1 1 1 1 22 12 12 12 12 12
1 29 30 1 1 31 1 1 32 33 34 35 36 1 1 1 
1 1 37 1 1 1 1 1 1 29 38 1 1 1 1 1 
1 1 39 40 41 42 43 12 12 12 12 12
44 45 1 46 47 48 49 50 51 52 1 53 54 55 56 57 
1 1 1 1 58 59 60 61 1 62 62 1 1 63 64 1 
1 65 66 40 1 67 68 12 69 70 71 72
73 74 75 76 77 78 79 80 81 82 83 84 85 86 87 88 
89 90 91 92 93 94 95 96 97 98 99 100 101 102 103 101 
101 104 105 106 101 107 108 109 110 111 109 112
12 12 12 12 12 12 12 12 12 12 12 12 12 12 12 12 
12 12 12 12 12 12 12 12 12 12 12 12 12 12 113 114 
115 116 117 117 118 114 119 12 12 12 12 12
12 12 12 12 12 12 12 12 12 12 12 12 12 12 12 12 
12 12 12 12 12 12 12 12 12 12 12 12 12 12 120 121 
122 12 12 123 124 121 122 12 12 12 12 12
12 12 12 12 12 12 12 12 12 12 12 12 12 12 12 12 
12 12 12 12 12 12 12 12 12 12 12 12 12 12 120 121 
125 126 127 128 121 121 122 12 12 12 12 12